################   #################
#..................................#
#..................................#
#..................................#
#..................................#
#..................................#
#..................................#
#                 #                #
                                    
                                    
#                                  #
#                                  #
#                                  #
#                                  #
#                                  #
#                                  #
#                                  #
#                                  #
#                                  #
################   #################
