################....################
#..................................#
#..................................#
#..................................#
#..................................#
#..................................#
#........################..........#
#........#              #..........#
#........#              #..........#
.........#              #...........
.........#              #...........
#........#              #..........#
#........################..........#
#..................................#
#..................................#
#..................................#
#..................................#
#..................................#
#..................................#
################....################
