               #....#               
               #....#               
               #....#               
               #....#               
               #....#               
           ####......####           
           #............#           
           #............#           
###########..............###########
....................................
....................................
###########..............###########
           #............#           
           #............#           
           ####......####           
               #....#               
               #....#               
               #....#               
               #....#               
               #....#               
