################....################
#..................................#
#..................................#
#..................................#
#..................................#
#..................................#
#..................................#
#..................................#
#..................................#
....................................
....................................
#..................................#
#..................................#
#..................................#
#..................................#
#..................................#
#..................................#
#..................................#
#..................................#
################....################
