               #....#               
               #....#               
               #....#               
               #....#               
               #....#               
           ####......####           
           #............#           
           #............#           
###########..............###########
................|__|................
................|--|................
###########..............###########
           #............#           
           #............#           
           ####......####           
               #....#               
               #....#               
               #....#               
               #....#               
               #....#               
